00100000100000000100
00100000000001000000
00111000010000000000
00000000000001110000
11110010000100000100
00100101000000000000
00000101000000100000
00000101000100000000
00000000100000000000
00010000000001000010
00000001000000000000
00000000000010000000
01000000001000000100
00000000000100000000
00000001000000000010
00000100000001000000
00000000010000000000
00010000000000000100
00000000001000000000
00000010000000000000
00100000100000000100
00000000000001000000
00111000010000000000
00000000000001110000
00010000000100000100
00100001000000000000
00000000000000100000
00000100000100000000
00000000100000000000
00010000000001000010
00000001000000000000
00000000000010000000
01000000001000000100
00000000000100000000
00000001000000000010
00000100000001000000
00000000010000000000
00010000000000000100
00000000001000000000
00000010000000000000
00100000100000000100
00000000000001000000
00111000010000000000
00000000000001110000
00010000000100000100
00100001000000000000
00000000000000100000
00000100000100000000
00000000100000000000
00010000000001000010
00000001000000000000
00000000000010000000
01000000001000000100
00000000000100000000
1101000111110000010
00010100000001000000
00010010010011111111
00010010010000000000
11110010001110000000
00000010000010000000